7
34 4 3 26 9 44 27 
32 25 8 29 19 43 16 
30 22 45 48 46 6 40 
15 36 13 5 17 18 35 
1 7 0 24 20 39 14 
41 31 12 11 42 38 10 
21 37 33 23 28 47 2
