7
32 36 43 31 12 44 13 
2 39 10 47 7 18 34 
17 1 37 22 3 26 25 
20 40 48 30 35 15 42 
5 24 46 29 14 19 8 
4 45 33 27 38 28 16 
0 6 11 23 21 41 9 
