7
42 16 5 39 38 32 23 
20 31 29 1 40 17 19 
44 34 36 48 14 46 30 
45 8 21 28 11 4 0 
12 13 18 25 41 3 10 
7 37 26 22 6 2 35 
33 43 47 24 27 9 15
