7
27 9 8 6 10 14 37 
32 24 5 4 43 12 36 
48 31 15 35 3 22 33 
26 47 23 28 11 39 17 
45 25 0 29 21 16 30 
13 42 1 44 46 19 2 
38 34 18 41 20 7 40 
