7
10 34 36 7 42 27 48 
24 41 11 33 45 18 12 
2 44 26 25 5 32 8 
17 28 35 39 9 38 4 
43 14 37 0 20 31 46 
15 40 29 6 13 19 22 
1 3 23 16 47 30 21
