7
37 30 11 15 40 13 35 
26 42 3 8 18 0 5 
29 17 19 24 4 34 43 
9 14 20 10 38 36 47 
46 48 7 1 44 12 41 
31 28 39 32 16 25 23 
2 45 27 6 21 33 22
