7
46 27 38 17 42 13 37 
8 23 36 9 30 10 41 
22 15 11 35 14 4 7 
16 24 34 5 40 47 43 
31 6 32 2 39 12 20 
44 18 28 29 0 26 45 
48 25 21 19 3 1 33
