7
48 28 23 41 20 2 10 
16 38 43 15 27 25 8 
9 31 32 47 1 37 18 
39 40 14 30 13 33 44 
24 5 29 19 36 45 7 
22 46 4 11 35 0 17 
3 12 6 34 21 42 26
