7
45 32 28 1 16 29 0 
25 21 23 8 33 34 11 
18 47 4 37 13 44 26 
42 38 39 5 15 43 6 
24 40 3 27 35 22 10 
2 14 12 48 20 7 17 
36 41 30 31 19 9 46
