8
23 55 17 40 59 12 10 48 
8 63 28 34 43 50 30 13 
0 60 32 33 31 4 15 22 
35 18 41 2 14 53 36 57 
46 5 19 21 3 62 7 52 
42 29 47 24 44 25 38 54 
6 51 26 45 11 56 1 20 
61 58 27 9 49 39 37 16
