8
20 40 44 52 45 30 57 60 
5 1 54 33 23 19 32 58 
55 43 38 42 51 48 25 11 
29 21 22 47 61 15 6 50 
34 63 3 8 46 49 14 56 
28 0 7 36 26 10 4 16 
9 2 18 17 35 12 53 39 
24 13 62 59 27 41 31 37
