8
38 58 52 21 34 4 36 61 
25 32 35 42 26 10 23 5 
50 6 63 13 24 37 11 46 
45 62 3 12 1 51 20 33 
54 7 53 57 19 28 27 41 
49 31 8 29 43 0 22 30 
59 60 14 2 48 40 15 16 
9 18 47 17 56 39 55 44
