8
0 16 52 55 56 20 57 31 
14 34 32 35 18 25 19 17 
47 27 15 26 30 9 42 21 
13 6 40 49 39 44 24 51 
45 29 23 53 41 58 7 63 
33 22 36 2 61 11 54 37 
1 8 60 50 3 62 28 38 
10 48 43 4 5 12 59 46 
