8
59 8 23 54 56 42 6 20 
28 61 60 52 48 41 27 24 
30 45 19 58 57 18 1 39 
11 63 4 49 13 36 32 9 
17 22 0 34 37 43 12 3 
38 29 62 2 31 44 21 35 
10 33 16 55 25 47 15 14 
46 26 51 53 7 50 5 40
