8
47 2 54 19 9 46 50 25 
59 63 29 7 38 30 44 4 
16 21 24 39 26 31 22 41 
49 8 52 55 60 6 14 61 
3 11 34 56 10 57 33 13 
45 1 62 15 0 36 28 42 
48 35 58 20 27 53 51 32 
12 43 5 37 40 23 17 18
