8
38 11 52 42 53 2 30 23 
18 37 49 61 12 27 26 0 
20 6 56 25 16 14 48 59 
54 58 8 51 63 15 36 55 
13 62 28 24 33 17 46 50 
22 40 19 39 60 44 35 9 
41 45 7 3 29 31 4 32 
5 43 1 21 57 10 34 47
