8
20 30 43 10 56 22 60 28 
36 8 61 46 42 26 7 55 
6 51 59 9 35 58 16 62 
40 12 48 53 44 13 5 32 
29 38 41 39 27 18 33 45 
54 50 17 19 57 31 49 15 
52 0 25 34 11 1 63 3 
14 2 21 37 47 4 23 24
