8
18 44 19 35 51 3 34 28 
41 58 9 48 53 40 21 23 
16 50 0 49 12 46 24 6 
20 60 38 33 31 15 39 37 
62 55 1 27 14 42 4 56 
63 2 5 26 7 17 54 22 
57 29 45 32 52 11 47 13 
59 25 8 43 61 10 36 30
